Afghanistan	Afghanistan
Afghanistan, Islamic Republic of	Afghanistan
Albania	Albania
Algeria	Algeria
American Samoa	American Samoa
American+Samoa	American Samoa
Andorra	Andorra
Angola	Angola
Anguilla	Anguilla
Antarctica	Antarctica
Antigua and Barbuda	Antigua and Barbuda
Antigua+and+Barbuda	Antigua and Barbuda
Arab World	Arab World
Argentina	Argentina
Armenia	Armenia
Armenia, Republic of	Armenia
Aruba	Aruba
Australia	Australia
Austria	Austria
Azerbaijan	Azerbaijan
Azerbaijan, Republic of	Azerbaijan
Bahamas	Bahamas
Bahamas, The	Bahamas
Bahrain	Bahrain
Bahrain, Kingdom of	Bahrain
Bangladesh	Bangladesh
Barbados	Barbados
Belarus	Belarus
Belgium	Belgium
Belize	Belize
Benin	Benin
Bermuda	Bermuda
Bhutan	Bhutan
Bolivia	Bolivia
Bolivia (Plurinational State of)	Bolivia
Bonaire, Sint Eustatius and Saba	Bonaire, Sint Eustatius and Saba
Bonaire,+Sint+Eustatius+and+Saba	Bonaire, Sint Eustatius and Saba
Bosnia and Herzegovina	Bosnia and Herzegovina
Bosnia+and+Herzegovina	Bosnia and Herzegovina
Botswana	Botswana
Bouvet+Island	Bouvet+Island
Brazil	Brazil
British Indian Ocean Territory	British Indian Ocean Territory
British+Indian+Ocean+Territory	British Indian Ocean Territory
British Virgin Islands	British Virgin Islands
British+Virgin+Islands	British Virgin Islands
Brunei Darussalam	Brunei Darussalam
Brunei	Brunei Darussalam
Brunei+Darussalam	Brunei Darussalam
Bulgaria	Bulgaria
Burkina Faso	Burkina Faso
Burkina+Faso	Burkina Faso
Burma	Burma
Burundi	Burundi
Cabo Verde	Cabo Verde
Cambodia	Cambodia
Cameroon	Cameroon
Canada	Canada
Cape+Verde	Cape+Verde
Caribbean	Caribbean
Caribbean Netherlands	Caribbean Netherlands
Caribbean+Netherlands	Caribbean Netherlands
Cayman Islands	Cayman Islands
Cayman+Islands	Cayman Islands
Central African Republic	Central African Republic
Central+African+Republic	Central African Republic
Central America	Central America
Central Asia	Central Asia
Central Europe and the Baltics	Central Europe and the Baltics
Chad	Chad
Channel Islands	Channel Islands
Chile	Chile
China	China
China, P.R.: Mainland	China
China, Hong Kong SAR	China, Hong Kong SAR
China, P.R.: Hong Kong	China, Hong Kong SAR
Hong Kong SAR	China, Hong Kong SAR
Hong Kong SAR, China	China, Hong Kong SAR
Hong+Kong	China, Hong Kong SAR
China, Macao SAR	China, Macao SAR
China, P.R.: Macao	China, Macao SAR
Macao SAR, China	China, Macao SAR
Macau	China, Macao SAR
Christmas Island	Christmas Island
Christmas+Island	Christmas Island
Cocos (Keeling) Islands	Cocos (Keeling) Islands
Cocos+(Keeling)+Islands	Cocos (Keeling) Islands
Collectivity+of+Saint+Martin	Collectivity+of+Saint+Martin
Colombia	Colombia
Commonwealth+of+Puerto+Rico	Commonwealth+of+Puerto+Rico
Commonwealth+of+The+Bahamas	Commonwealth+of+The+Bahamas
Comoros	Comoros
Congo	Congo
Congo, Democratic Republic of	Congo
Congo, Republic of	Congo
Republic of Congo	Congo
Republic+of+the+Congo	Congo
Cook Islands	Cook Islands
Cook+Islands	Cook Islands
Costa Rica	Costa Rica
Costa+Rica	Costa Rica
Cote d'Ivoire	Cote d'Ivoire
Cote+d'Ivoire	Cote d'Ivoire
Côte d'Ivoire	Cote d'Ivoire
Croatia	Croatia
Cuba	Cuba
Curacao	Curacao
Curaçao	Curacao
Curacao and Sint Maarten	Curacao and Sint Maarten
Curacao & St. Maarten	Curacao and Sint Maarten
Cyprus	Cyprus
Czech Republic	Czech Republic
Czech+Republic	Czech Republic
Dem. People's Rep. Korea	Dem. People's Rep. Korea
Dem. People's Republic of Korea	Dem. People's Rep. Korea
Democratic Republic of the Congo	Democratic Republic of the Congo
Dem. Rep. Congo	Democratic Republic of the Congo
Democratic+Republic+of+the+Congo	Democratic Republic of the Congo
Denmark	Denmark
Djibouti	Djibouti
Dominica	Dominica
Dominican Republic	Dominican Republic
Dominican+Republic	Dominican Republic
East+Timor	East+Timor
Ecuador	Ecuador
Egypt	Egypt
El Salvador	El Salvador
El+Salvador	El Salvador
Equatorial Guinea	Equatorial Guinea
Equatorial+Guinea	Equatorial Guinea
Eritrea	Eritrea
Estonia	Estonia
Ethiopia	Ethiopia
Euro area	Euro area
European Union	European Union
Faeroe Islands	Faeroe Islands
Falkland Islands	Falkland Islands
Falkland Islands (Malvinas)	Falkland Islands
Falkland+Islands+(Islas+Malvinas)	Falkland Islands
Falkland Islands (Islas Malvinas)	Falkland Islands
Faroe Islands	Faroe Islands
Faroe+Islands	Faroe Islands
Federated+States+of+Micronesia	Federated+States+of+Micronesia
Fiji	Fiji
Finland	Finland
Fragile and conflict affected situations	Fragile and conflict affected situations
France	France
French Guiana	French Guiana
French Polynesia	French Polynesia
French Southern Territories	French Southern Territories
French Territories: French Polynesia	French Territories: French Polynesia
French Territories: New Caledonia	French Territories: New Caledonia
French+Guiana	French+Guiana
French+Polynesia	French+Polynesia
French+Southern+and+Antarctic+Lands	French+Southern+and+Antarctic+Lands
FYR Macedonia	FYR Macedonia
Gabon	Gabon
Gambia	Gambia
Gambia, The	Gambia
Georgia	Georgia
Germany	Germany
Ghana	Ghana
Gibraltar	Gibraltar
Greece	Greece
Greenland	Greenland
Grenada	Grenada
Guadeloupe	Guadeloupe
Guam	Guam
Guatemala	Guatemala
Guernsey	Guernsey
Guiana, French	Guiana, French
Guinea	Guinea
Guinea-Bissau	Guinea
Guyana	Guyana
Haiti	Haiti
Heard+Island+and+McDonald+Islands	Heard+Island+and+McDonald+Islands
Heavily indebted poor countries (HIPC)	Heavily indebted poor countries (HIPC)
Holy See	Holy See
Honduras	Honduras
Hungary	Hungary
Iceland	Iceland
India	India
Indonesia	Indonesia
Republic+of+Indonesia	Indonesia
Iran	Iran
Iran (Islamic Republic of)	Iran
Iran, Islamic Republic of	Iran
Islamic Republic of Iran	Iran
Iraq	Iraq
Ireland	Ireland
Isle of Man	Isle of Man
Isle+of+Man	Isle of Man
Israel	Israel
Italy	Italy
Jamaica	Jamaica
Jan+Mayen	Jan+Mayen
Japan	Japan
Jarvis+Island	Jarvis+Island
Jersey	Jersey
Jordan	Jordan
Kazakhstan	Kazakhstan
Kenya	Kenya
Kiribati	Kiribati
Korea	Korea
Korea, Democratic People's Rep. of	Korea
Korea, Republic of	Korea
Republic of Korea	Korea
Kosovo	Kosovo
Kosova+(Kosovo)	Kosovo
Kosovo, Republic of	Kosovo
Republic+of+Kosovo	Kosovo
Kuwait	Kuwait
Kyrgyz Republic	Kyrgyz Republic
Kyrgyzstan	Kyrgyzstan
Lao P.D.R.	Lao P.D.R.
Lao PDR	Lao P.D.R.
Lao People's Democratic Republic	Lao P.D.R.
Laos	Laos
Latvia	Latvia
Lebanon	Lebanon
Lesotho	Lesotho
Liberia	Liberia
Libya	Libya
Liechtenstein	Liechtenstein
Lithuania	Lithuania
Luxembourg	Luxembourg
Macedonia	Macedonia
Macedonia+(FYROM)	Macedonia
Macedonia, FYR	Macedonia
Madagascar	Madagascar
Malawi	Malawi
Malaysia	Malaysia
Maldives	Maldives
Mali	Mali
Malta	Malta
Marshall Islands	Marshall Islands
Marshall Islands, Republic of	Marshall Islands
Marshall+Islands	Marshall Islands
Martinique	Martinique
Mauritania	Mauritania
Mauritius	Mauritius
Mayotte	Mayotte
Melanesia	Melanesia
Mexico	Mexico
Micronesia	Micronesia
Micronesia (Fed. States of)	Micronesia
Micronesia, Federated States of	Micronesia
Moldova	Moldova
Republic of Moldova	Moldova
Monaco	Monaco
Mongolia	Mongolia
Montenegro	Montenegro
Montserrat	Montserrat
Morocco	Morocco
Mozambique	Mozambique
Myanmar	Myanmar
Myanmar+(Burma)	Myanmar
Republic+of+the+Union+of+Myanmar	Myanmar
Namibia	Namibia
Nauru	Nauru
Nepal	Nepal
Netherlands	Netherlands
Netherlands Antilles	Netherlands Antilles
Netherlands+Antilles	Netherlands Antilles
New Caledonia	New Caledonia
New+Caledonia	New Caledonia
New Zealand	New Zealand
New+Zealand	New Zealand
Nicaragua	Nicaragua
Niger	Niger
Nigeria	Nigeria
Niue	Niue
Norfolk Island	Norfolk Island
Norfolk+Island	Norfolk Island
North America	North America
North+Korea	North+Korea
Northern Africa	Northern Africa
NORTHERN AMERICA	NORTHERN AMERICA
Northern Europe	Northern Europe
Northern Mariana Islands	Northern Mariana Islands
Northern+Mariana+Islands	Northern Mariana Islands
Norway	Norway
Kingdom+of+Norway	Norway
Oman	Oman
Pacific island small states	Pacific island small states
Pakistan	Pakistan
Palau	Palau
Palestine	Palestine
Palestinian+Territories	Palestinian+Territories
Panama	Panama
Papua New Guinea	Papua New Guinea
Papua+New+Guinea	Papua New Guinea
Paraguay	Paraguay
Peru	Peru
Philippines	Philippines
Pitcairn Islands	Pitcairn Islands
Pitcairn+Islands	Pitcairn Islands
Poland	Poland
Polynesia	Polynesia
Portugal	Portugal
Puerto Rico	Puerto Rico
Puerto+Rico	Puerto Rico
Qatar	Qatar
Reunion	Reunion
Romania	Romania
Russia	Russia
Russian Federation	Russian Federation
Russian+Federation	Russian Federation
Rwanda	Rwanda
Saint Helena	Saint Helena
Saint Kitts and Nevis	Saint Kitts and Nevis
Saint+Kitts+and+Nevis	Saint Kitts and Nevis
Saint Lucia	Saint Lucia
Saint+Lucia	Saint Lucia
Saint Pierre and Miquelon	Saint Pierre and Miquelon
Saint+Pierre+and+Miquelon	Saint Pierre and Miquelon
Saint Vincent and the Grenadines	Saint Vincent and the Grenadines
Saint+Barthelemy	Saint+Barthelemy
Saint-Barthelemy	Saint+Barthelemy
Saint+Martin	Saint+Martin
Saint+Vincent+and+the+Grenadines	Saint+Vincent+and+the+Grenadines
Samoa	Samoa
San Marino	San Marino
San+Marino	San Marino
Sao Tome and Principe	Sao Tome and Principe
Sao+Tome+and+Principe	Sao Tome and Principe
São Tomé and Principe	Sao Tome and Principe
São Tomé and Príncipe	Sao Tome and Principe
Saudi Arabia	Saudi Arabia
Saudi+Arabia	Saudi Arabia
SEFER + SSIO (**)	SEFER + SSIO (**)
Senegal	Senegal
Serbia	Serbia
Serbia, Republic of	Serbia
Seychelles	Seychelles
Sierra Leone	Sierra Leone
Sierra+Leone	Sierra Leone
Singapore	Singapore
Sint Maarten	Sint Maarten
Sint Maarten (Dutch part)	Sint Maarten
Sint+Maarten	Sint Maarten
Slovak Republic	Slovak Republic
Slovakia	Slovakia
Slovenia	Slovenia
Small states	Small states
Solomon Islands	Solomon Islands
Solomon+Islands	Solomon Islands
Somalia	Somalia
South Africa	South Africa
South+Africa	South Africa
South America	South America
South Asia	South Asia
South Sudan	South Sudan
South+Georgia+and+the+South+Sandwich+Islands	South+Georgia+and+the+South+Sandwich+Islands
South+Korea	South+Korea
South+Sudan	South+Sudan
South-Central Asia	South-Central Asia
South-Eastern Asia	South-Eastern Asia
Southern Africa	Southern Africa
Southern Asia	Southern Asia
Southern Europe	Southern Europe
Spain	Spain
Sri Lanka	Sri Lanka
Sri+Lanka	Sri Lanka
St+Helena	St+Helena
St+Pierre+and+Miquelon	St+Pierre+and+Miquelon
St. Kitts and Nevis	St. Kitts and Nevis
St+Kitts+and+Nevis	St. Kitts and Nevis
St. Lucia	St. Lucia
St+Lucia	St. Lucia
St. Martin (French part)	St. Martin (French part)
St. Vincent and the Grenadines	St. Vincent and the Grenadines
St+Vincent+and+the+Grenadines	St. Vincent and the Grenadines
State of Palestine	State of Palestine
Sudan	Sudan
Suriname	Suriname
Svalbard+and+Jan+Mayen	Svalbard+and+Jan+Mayen
Swaziland	Swaziland
Sweden	Sweden
Kingdom+of+Sweden	Sweden
Switzerland	Switzerland
Syria	Syria
Syrian Arab Republic	Syrian Arab Republic
Taiwan	Taiwan
Taiwan Province of China	Taiwan
Tajikistan	Tajikistan
Tanzania	Tanzania
TFYR Macedonia	TFYR Macedonia
Thailand	Thailand
The Bahamas	The Bahamas
The+Bahamas	The Bahamas
The Gambia	The Gambia
The+Gambia	The Gambia
The+Netherlands	The+Netherlands
Timor-Leste	Timor-Leste
Timor-Leste, Dem. Rep. of	Timor-Leste
Togo	Togo
Tokelau	Tokelau
Tokelau Islands	Tokelau Islands
Tonga	Tonga
Trinidad and Tobago	Trinidad and Tobago
Trinidad+&amp;+Tobago	Trinidad and Tobago
Trinidad+and+Tobago	Trinidad and Tobago
Tunisia	Tunisia
Turkey	Turkey
Turkmenistan	Turkmenistan
Turks and Caicos Islands	Turks and Caicos Islands
Turks+and+Caicos+Islands	Turks and Caicos Islands
Tuvalu	Tuvalu
U.S.+Virgin+Islands	U.S.+Virgin+Islands
Uganda	Uganda
Ukraine	Ukraine
United Arab Emirates	United Arab Emirates
United Kingdom	United Kingdom
United Republic of Tanzania	United Republic of Tanzania
United States	United States
United States of America	United States
United+States	United States
United States Virgin Islands	United States Virgin Islands
United+States+Virgin+Islands	United States Virgin Islands
United+Arab+Emirates	United+Arab+Emirates
United+Kingdom	United+Kingdom
United+States+Minor+Outlying+Islands	United+States+Minor+Outlying+Islands
Uruguay	Uruguay
US Pacific Islands	US Pacific Islands
US Virgin Islands	US Virgin Islands
US+Virgin+Islands	US Virgin Islands
Uzbekistan	Uzbekistan
Value of Total Investment	Value of Total Investment
Vanuatu	Vanuatu
Vatican	Vatican
Vatican+City	Vatican+City
Venezuela	Venezuela
Venezuela (Bolivarian Republic of)	Venezuela
Venezuela, Republica Bolivariana de	Venezuela
Venezuela, República Bolivariana de	Venezuela
Viet Nam	Viet Nam
Vietnam	Viet Nam
Virgin Islands	Virgin Islands
Virgin Islands, British	Virgin Islands
Virgin+Islands	Virgin Islands
Wallis and Futuna	Wallis and Futuna
Wallis and Futuna Islands	Wallis and Futuna
Wallis+and+Futuna	Wallis and Futuna
West Bank and Gaza	West Bank and Gaza
Western Africa	Western Africa
Western Asia	Western Asia
Western Europe	Western Europe
Western Sahara	Western Sahara
Western+Sahara	Western Sahara
Yemen	Yemen
Yemen, Republic of	Yemen
Zambia	Zambia
Zimbabwe	Zimbabwe
